Ask Amr|AA|Amerikansk Ask|White Ash
Ask Eur|AE|Europæisk Ask|Ask
Ask Thermo|AT|Thermo-behandlet Ask
Ahorn|AH|Maple
Asp|AP
Ayous|AY|Obeche
Azobe|AZ|Azobé|Ekki
Bøg Eur|BE|Europæisk Bøg|Bøg
Birk|BI
Bøg Letdampet|BL|Letdampet Europæisk Bøg
Cumaru|CU|Brazilian Teak
Douglas|DO|Douglas Gran
Eg Amr|EA|Amerikansk Hvid-Eg|White Oak
Eg Eur|EE|Europæisk Eg|Eg
Elm|EL
Fyr|FY|Scots Pine
Fyr Thermo|FT|Thermo-behandlet Fyr
Gran|GR|Norway Spruce
Ipe|IP|Ipé|Brazilian Walnut
Iroko|IR|Kambala
Jatoba|JA|Jatobá|Brazilian Cherry
Lærk Eur|LE|Europæisk Lærk|Lærk
Lærk Sib|LS|Sibirisk Lærk
Merbau|ME
Oregon Pine|OP|Douglas Fir
Robinie|RO|Black Locust
Sapelli|SA|Sapelli Mahogni|Mahogni
Sipo|SI|Sipo Mahogni|Utile
Tiama|TI|Tiama Mahogni
Teak Plantage|TP|Plantage Teak|Teak
Valnød Amr|VA|Amerikansk Valnød|Valnød
Wenge|WE|Wengé
